13
49
WW===============================================
|.%.......&.........L.p.......................W==
|...................o.|.......................|||
|...................".|....k..................|||
|...................".p=========........o....o|||
|..............H...."..................."p==="|||
|p=================."............H..H..."p..."|||
|...........g.....g."............p====.."|..."|||
|...........%.....&.O...................l|...l|||
|...........4.....5XXX..........H.......G....G...
|..................XXX..................1....1...
|.k..E........H....XXX..H..pS...H.P.....|....|..#
W================================================

WW===============================================
|.....................u.......................W==
|.....................v.......................|||
|.....................d....k..................|||
|.....................lhhhhhhhhr..............|||
|........................................lhhr.|||
|lhhhhhhhhhhhhhhhhr......................u....|||
|................................lhhhr...v....|||
|........................................d....|||
|................................................
|................................................
|..........................s.....................
W================================================