19
39
WW=====================================
|.L................p................W==
|.o................|................|||
|."................|................|||
|."................|................|||
|."................|................|||
|.".p==============|................|||
|.".p..............|................|||
|.".|..............|................|||
|.".|..............|................|||
|.".|.l............................o|||
|.O.|.E........H..................."|||
|XXXp==============............k..."|||
|XXX........................p====.."|||
|XXX...............................l|||
|p==...............................G...
||||.........................l.....1...
|p===........H.H..E.......pS.P.....|..#
W======================================

WW=====================================
|..................u................W==
|..................v................|||
|..................v................|||
|..................v................|||
|..................v................|||
|...lhhhhhhhhhhhhhrv................|||
|...u..............v................|||
|...v..............v................|||
|...v..............d................|||
|...v...............................|||
|...d...............................|||
|...lhhhhhhhhhhhhhr.................|||
|...........................lhhhr...|||
|...................................|||
|lhr................................|||
|lhr...................................
|lhhr.....................s............
W======================================