13
39
W======================================
W.....g.%...........g...............W==
|.....%.............%...............|||
|.....5.............6...............|||
|...............l..................o|||
|...............P..................o|||
|.....p=============H..S....S......"|||
|.....&........g...p============..."|||
|..............&..........+....g...l|||
|..............4...............+...G...
|..............................4...0...
|S......E..........................|..#
W======================================

W======================================
W...................................W==
|...................................|||
|...................................|||
|...................................|||
|...................................|||
|.....lhhhhhhhhhhhhr................|||
|..................lhhhhhhhhhhhr....|||
|...................................|||
|......................................
|......................................
|......................................
W======================================