13
24
W=======================
W....................W==
|....................|||
|....................|||
|...................o|||
|...................o|||
|..................."|||
|..................."|||
|...................l|||
|...................G...
|...................0...
|..P................|..#
W=======================

W=======================
W....................W==
|....................|||
|....................|||
|....................|||
|....................|||
|....................|||
|....................|||
|....................|||
|.......................
|.......................
|.......................
W=======================