13
34
WW================================
|..............................W==
|..............................|||
|..............................|||
|.............................o|||
|............................."|||
|............................."|||
|........................k...."|||
|.......................p==...l|||
|.............................G...
|.............................1...
|.P.....E.....H...S...p=......|..#
W=================================

WW================================
|..............................W==
|..............................|||
|..............................|||
|..............................|||
|..............................|||
|..............................|||
|..............................|||
|.......................lhr....|||
|..............................|||
|.................................
|.....................lr..........
W=================================