13
24
W=======================
W....................W==
|....................|||
|.H.H.H..............|||
|...................o|||
|.H.HPH.............o|||
|p==========........"|||
|..................."|||
|...................l|||
|..............H....G...
|...................1...
|..k......H.H.H.H...|..#
W=======================

W=======================
W....................W==
|....................|||
|....................|||
|....................|||
|....................|||
|lhhhhhhhhhr.........|||
|....................|||
|....................|||
|.......................
|.......................
|.......................
W=======================