19
34
WW================================
|..............................W==
|..............................|||
|..............................|||
|..............................|||
|..............................|||
|..............................|||
|..............................|||
|..............................|||
|..............................|||
|..............................|||
|..............................|||
|..............................|||
|..............................|||
|..............................|||
|.................................
|.................................
|..............P.................#
W=================================

WW================================
|..............................W==
|..............................|||
|..............................|||
|..............................|||
|..............................|||
|..............................|||
|..............................|||
|..............................|||
|..............................|||
|..............................|||
|..............................|||
|..............................|||
|..............................|||
|..............................|||
|.................................
|.................................
|.................................
W=================================